"Run","Time Step","Population Size","Group Members","Floaters","Lambda","Trait Index  0","Trait Index  1"
    4,      0,      15773,          0,      15773,   1.000000,            15773,                0
    4,      1,      15773,          0,      15773,   1.000000,             9051,             6722
    4,      2,     348551,          0,     348551,  22.097952,           342403,             6148
    4,      3,     374355,          0,     374355,   1.074032,           368722,             5633
    4,      4,     363761,          0,     363761,   0.971701,           359044,             4717
    4,      5,     332835,          0,     332835,   0.914983,           332475,              360
    4,      6,     124188,          0,     124188,   0.373122,           124188,                0
    4,      7,      77645,          0,      77645,   0.625221,            77645,                0
    4,      8,      73815,          0,      73815,   0.950673,            73815,                0
    4,      9,      72899,          0,      72899,   0.987591,            72899,                0
    4,     10,      72138,          0,      72138,   0.989561,            72138,                0
    4,     11,      71375,          0,      71375,   0.989423,            71375,                0
    4,     12,      69542,          0,      69542,   0.974319,            69542,                0
    4,     13,      69078,          0,      69078,   0.993328,            65957,             3121
    4,     14,     220150,          0,     220150,   3.186977,           217268,             2882
    4,     15,     232872,          0,     232872,   1.057788,           230224,             2648
    4,     16,     227412,          0,     227412,   0.976554,           225283,             2129
    4,     17,     206066,          0,     206066,   0.906135,           206066,                0
    4,     18,      99728,          0,      99728,   0.483961,            99728,                0
    4,     19,      79066,          0,      79066,   0.792816,            79066,                0
    4,     20,      75238,          0,      75238,   0.951585,            75238,                0
    4,     21,      71593,          0,      71593,   0.951554,            71593,                0
    4,     22,      68375,          0,      68375,   0.955051,            68375,                0
    4,     23,      65645,          0,      65645,   0.960073,            65645,                0
    4,     24,      62466,          0,      62466,   0.951573,            62466,                0
    4,     25,      60601,          0,      60601,   0.970144,            59179,             1422
    4,     26,     128637,          0,     128637,   2.122688,           127339,             1298
    4,     27,     131064,          0,     131064,   1.018867,           129878,             1186
    4,     28,     128062,          0,     128062,   0.977095,           127121,              941
    4,     29,     116083,          0,     116083,   0.906459,           115998,               85
    4,     30,      72206,          0,      72206,   0.622020,            72206,                0
    4,     31,      58685,          0,      58685,   0.812744,            58685,                0
    4,     32,      54759,          0,      54759,   0.933100,            54759,                0
    4,     33,      51671,          0,      51671,   0.943607,            51671,                0
    4,     34,      48952,          0,      48952,   0.947379,            48952,                0
    4,     35,      46553,          0,      46553,   0.950993,            46553,                0
    4,     36,      44385,          0,      44385,   0.953429,            44385,                0
    4,     37,      42697,          0,      42697,   0.961969,            41282,             1415
    4,     38,      96339,          0,      96339,   2.256341,            95014,             1325
    4,     39,      99095,          0,      99095,   1.028607,            97911,             1184
    4,     40,      94632,          0,      94632,   0.954962,            93673,              959
    4,     41,      88409,          0,      88409,   0.934240,            88409,                0
    4,     42,      49321,          0,      49321,   0.557873,            49321,                0
    4,     43,      41053,          0,      41053,   0.832363,            41053,                0
    4,     44,      38809,          0,      38809,   0.945339,            38809,                0
    4,     45,      36603,          0,      36603,   0.943157,            36603,                0
    4,     46,      34604,          0,      34604,   0.945387,            34604,                0
    4,     47,      32976,          0,      32976,   0.952953,            32976,                0
    4,     48,      31160,          0,      31160,   0.944930,            31160,                0
    4,     49,      29994,          0,      29994,   0.962580,            27303,             2691
    4,     50,     126411,          0,     126411,   4.214543,           123874,             2537
    4,     51,     139439,          0,     139439,   1.103061,           137073,             2366
    4,     52,     141634,          0,     141634,   1.015742,           139832,             1802
    4,     53,     131086,          0,     131086,   0.925526,           130481,              605
    4,     54,      81129,          0,      81129,   0.618899,            81129,                0
    4,     55,      40149,          0,      40149,   0.494879,            40149,                0
    4,     56,      38478,          0,      38478,   0.958380,            38478,                0
    4,     57,      36958,          0,      36958,   0.960497,            36958,                0
    4,     58,      35587,          0,      35587,   0.962904,            35587,                0
    4,     59,      34487,          0,      34487,   0.969090,            34487,                0
    4,     60,      32729,          0,      32729,   0.949024,            32729,                0
    4,     61,      31941,          0,      31941,   0.975923,            28727,             3214
    4,     62,     164781,          0,     164781,   5.158918,           161727,             3054
    4,     63,     181059,          0,     181059,   1.098786,           178178,             2881
    4,     64,     182773,          0,     182773,   1.009467,           180510,             2263
    4,     65,     164606,          0,     164606,   0.900603,           164606,                0
    4,     66,      65655,          0,      65655,   0.398862,            65655,                0
    4,     67,      47879,          0,      47879,   0.729251,            47879,                0
    4,     68,      46063,          0,      46063,   0.962071,            46063,                0
    4,     69,      44387,          0,      44387,   0.963615,            44387,                0
    4,     70,      42947,          0,      42947,   0.967558,            42947,                0
    4,     71,      41704,          0,      41704,   0.971057,            41704,                0
    4,     72,      40083,          0,      40083,   0.961131,            40083,                0
    4,     73,      39265,          0,      39265,   0.979592,            36336,             2929
    4,     74,     170684,          0,     170684,   4.346976,           167892,             2792
    4,     75,     192213,          0,     192213,   1.126134,           189566,             2647
    4,     76,     199063,          0,     199063,   1.035637,           196937,             2126
    4,     77,     181085,          0,     181085,   0.909687,           181085,                0
    4,     78,      73926,          0,      73926,   0.408239,            73926,                0
    4,     79,      54399,          0,      54399,   0.735857,            54399,                0
    4,     80,      52220,          0,      52220,   0.959944,            52220,                0
    4,     81,      50246,          0,      50246,   0.962198,            50246,                0
    4,     82,      48412,          0,      48412,   0.963500,            48412,                0
    4,     83,      46809,          0,      46809,   0.966888,            46809,                0
    4,     84,      45157,          0,      45157,   0.964708,            45157,                0
    4,     85,      43870,          0,      43870,   0.971499,            41674,             2196
    4,     86,     145326,          0,     145326,   3.312651,           143415,             1911
    4,     87,     148740,          0,     148740,   1.023492,           147155,             1585
    4,     88,     137322,          0,     137322,   0.923235,           136107,             1215
    4,     89,     120816,          0,     120816,   0.879801,           120816,                0
    4,     90,      61344,          0,      61344,   0.507747,            61344,                0
    4,     91,      49874,          0,      49874,   0.813022,            49874,                0
    4,     92,      47504,          0,      47504,   0.952480,            47504,                0
    4,     93,      45280,          0,      45280,   0.953183,            45280,                0
    4,     94,      43294,          0,      43294,   0.956140,            43294,                0
    4,     95,      41649,          0,      41649,   0.962004,            41649,                0
    4,     96,      39723,          0,      39723,   0.953756,            39723,                0
    4,     97,      38434,          0,      38434,   0.967550,            36708,             1726
    4,     98,     110202,          0,     110202,   2.867305,           108660,             1542
    4,     99,     113029,          0,     113029,   1.025653,           111684,             1345
    4,    100,     107367,          0,     107367,   0.949907,           106288,             1079
    4,    101,      99286,          0,      99286,   0.924735,            99286,                0
    4,    102,      50655,          0,      50655,   0.510193,            50655,                0
    4,    103,      40879,          0,      40879,   0.807008,            40879,                0
    4,    104,      38776,          0,      38776,   0.948555,            38776,                0
    4,    105,      36852,          0,      36852,   0.950382,            36852,                0
    4,    106,      35068,          0,      35068,   0.951590,            35068,                0
    4,    107,      33538,          0,      33538,   0.956370,            33538,                0
    4,    108,      31940,          0,      31940,   0.952353,            31940,                0
    4,    109,      30884,          0,      30884,   0.966938,            28980,             1904
    4,    110,     107216,          0,     107216,   3.471571,           105429,             1787
    4,    111,     116132,          0,     116132,   1.083159,           114496,             1636
    4,    112,     115275,          0,     115275,   0.992620,           113954,             1321
    4,    113,     104855,          0,     104855,   0.909607,           104855,                0
    4,    114,      47791,          0,      47791,   0.455782,            47791,                0
    4,    115,      37729,          0,      37729,   0.789458,            37729,                0
    4,    116,      36081,          0,      36081,   0.956320,            36081,                0
    4,    117,      34460,          0,      34460,   0.955073,            34460,                0
    4,    118,      32915,          0,      32915,   0.955165,            32915,                0
    4,    119,      31661,          0,      31661,   0.961902,            31661,                0
    4,    120,      30330,          0,      30330,   0.957961,            30330,                0
    4,    121,      29474,          0,      29474,   0.971777,            27034,             2440
    4,    122,     129327,          0,     129327,   4.387833,           127023,             2304
    4,    123,     142517,          0,     142517,   1.101990,           140382,             2135
    4,    124,     145210,          0,     145210,   1.018896,           143524,             1686
    4,    125,     131013,          0,     131013,   0.902231,           131013,                0
    4,    126,      53977,          0,      53977,   0.411997,            53977,                0
    4,    127,      40501,          0,      40501,   0.750338,            40501,                0
    4,    128,      38905,          0,      38905,   0.960594,            38905,                0
    4,    129,      37368,          0,      37368,   0.960494,            37368,                0
    4,    130,      36075,          0,      36075,   0.965398,            36075,                0
    4,    131,      34983,          0,      34983,   0.969730,            34983,                0
    4,    132,      33433,          0,      33433,   0.955693,            33433,                0
    4,    133,      32544,          0,      32544,   0.973410,            30283,             2261
    4,    134,     130598,          0,     130598,   4.012967,           128535,             2063
    4,    135,     140456,          0,     140456,   1.075484,           138577,             1879
    4,    136,     138703,          0,     138703,   0.987519,           137212,             1491
    4,    137,     125519,          0,     125519,   0.904948,           125508,               11
    4,    138,      55550,          0,      55550,   0.442562,            55550,                0
    4,    139,      42005,          0,      42005,   0.756166,            42005,                0
    4,    140,      40295,          0,      40295,   0.959291,            40295,                0
    4,    141,      38664,          0,      38664,   0.959523,            38664,                0
    4,    142,      37063,          0,      37063,   0.958592,            37063,                0
    4,    143,      35805,          0,      35805,   0.966058,            35805,                0
    4,    144,      34123,          0,      34123,   0.953023,            34123,                0
    4,    145,      33140,          0,      33140,   0.971192,            31325,             1815
    4,    146,     113443,          0,     113443,   3.423144,           111815,             1628
    4,    147,     117600,          0,     117600,   1.036644,           116111,             1489
    4,    148,     116390,          0,     116390,   0.989711,           115160,             1230
    4,    149,     108668,          0,     108668,   0.933654,           108619,               49
    4,    150,      52333,          0,      52333,   0.481586,            52333,                0
    4,    151,      39019,          0,      39019,   0.745591,            39019,                0
    4,    152,      37202,          0,      37202,   0.953433,            37202,                0
    4,    153,      35525,          0,      35525,   0.954922,            35525,                0
    4,    154,      34046,          0,      34046,   0.958367,            34046,                0
    4,    155,      32781,          0,      32781,   0.962844,            32781,                0
    4,    156,      31460,          0,      31460,   0.959702,            31460,                0
    4,    157,      30452,          0,      30452,   0.967959,            28770,             1682
    4,    158,     103176,          0,     103176,   3.388152,           101654,             1522
    4,    159,     108677,          0,     108677,   1.053317,           107342,             1335
    4,    160,     103149,          0,     103149,   0.949134,           102054,             1095
    4,    161,      94810,          0,      94810,   0.919156,            94809,                1
    4,    162,      45026,          0,      45026,   0.474908,            45026,                0
    4,    163,      35727,          0,      35727,   0.793475,            35727,                0
    4,    164,      34077,          0,      34077,   0.953816,            34077,                0
    4,    165,      32495,          0,      32495,   0.953576,            32495,                0
    4,    166,      31087,          0,      31087,   0.956670,            31087,                0
    4,    167,      29954,          0,      29954,   0.963554,            29954,                0
    4,    168,      28811,          0,      28811,   0.961841,            28811,                0
    4,    169,      27921,          0,      27921,   0.969109,            26159,             1762
    4,    170,     100377,          0,     100377,   3.595036,            98747,             1630
    4,    171,     107767,          0,     107767,   1.073622,           106265,             1502
    4,    172,     108437,          0,     108437,   1.006217,           107227,             1210
    4,    173,      99028,          0,      99028,   0.913231,            99028,                0
    4,    174,      44110,          0,      44110,   0.445430,            44110,                0
    4,    175,      34159,          0,      34159,   0.774405,            34159,                0
    4,    176,      32659,          0,      32659,   0.956088,            32659,                0
    4,    177,      31251,          0,      31251,   0.956888,            31251,                0
    4,    178,      29888,          0,      29888,   0.956385,            29888,                0
    4,    179,      28841,          0,      28841,   0.964969,            28841,                0
    4,    180,      27719,          0,      27719,   0.961097,            27719,                0
    4,    181,      26900,          0,      26900,   0.970454,            25013,             1887
    4,    182,     105504,          0,     105504,   3.922082,           103752,             1752
    4,    183,     114426,          0,     114426,   1.084566,           112817,             1609
    4,    184,     113885,          0,     113885,   0.995272,           112604,             1281
    4,    185,     103451,          0,     103451,   0.908381,           102811,              640
    4,    186,      75081,          0,      75081,   0.725764,            75081,                0
    4,    187,      35156,          0,      35156,   0.468241,            35156,                0
    4,    188,      33600,          0,      33600,   0.955740,            33600,                0
    4,    189,      32231,          0,      32231,   0.959256,            32231,                0
    4,    190,      31108,          0,      31108,   0.965158,            31108,                0
    4,    191,      30099,          0,      30099,   0.967565,            30099,                0
    4,    192,      28991,          0,      28991,   0.963188,            28991,                0
    4,    193,      28254,          0,      28254,   0.974578,            26178,             2076
    4,    194,     116746,          0,     116746,   4.132017,           114815,             1931
    4,    195,     127726,          0,     127726,   1.094050,           125966,             1760
    4,    196,     126997,          0,     126997,   0.994292,           125621,             1376
    4,    197,     113794,          0,     113794,   0.896037,           113147,              647
    4,    198,      80622,          0,      80622,   0.708491,            80622,                0
    4,    199,      37538,          0,      37538,   0.465605,            37538,                0
    4,    200,      35987,          0,      35987,   0.958682,            35987,                0
    4,    201,      34554,          0,      34554,   0.960180,            34554,                0
    4,    202,      33329,          0,      33329,   0.964548,            33329,                0
    4,    203,      32229,          0,      32229,   0.966996,            32229,                0
    4,    204,      30820,          0,      30820,   0.956282,            30820,                0
    4,    205,      30015,          0,      30015,   0.973881,            28101,             1914
    4,    206,     112272,          0,     112272,   3.740530,           110558,             1714
    4,    207,     117872,          0,     117872,   1.049879,           116324,             1548
    4,    208,     116245,          0,     116245,   0.986197,           115029,             1216
    4,    209,     105357,          0,     105357,   0.906336,           105357,                0
    4,    210,      47573,          0,      47573,   0.451541,            47573,                0
    4,    211,      37310,          0,      37310,   0.784268,            37310,                0
    4,    212,      35713,          0,      35713,   0.957196,            35713,                0
    4,    213,      34186,          0,      34186,   0.957242,            34186,                0
    4,    214,      32740,          0,      32740,   0.957702,            32740,                0
    4,    215,      31645,          0,      31645,   0.966555,            31645,                0
    4,    216,      30417,          0,      30417,   0.961195,            30417,                0
    4,    217,      29504,          0,      29504,   0.969984,            27702,             1802
    4,    218,     106206,          0,     106206,   3.599715,           104561,             1645
    4,    219,     113573,          0,     113573,   1.069365,           112073,             1500
    4,    220,     113528,          0,     113528,   0.999604,           112329,             1199
    4,    221,     103909,          0,     103909,   0.915272,           103909,                0
    4,    222,      46547,          0,      46547,   0.447959,            46547,                0
    4,    223,      35968,          0,      35968,   0.772724,            35968,                0
    4,    224,      34396,          0,      34396,   0.956294,            34396,                0
    4,    225,      32873,          0,      32873,   0.955722,            32873,                0
    4,    226,      31496,          0,      31496,   0.958112,            31496,                0
    4,    227,      30400,          0,      30400,   0.965202,            30400,                0
    4,    228,      29123,          0,      29123,   0.957993,            29123,                0
    4,    229,      28311,          0,      28311,   0.972118,            26587,             1724
    4,    230,     100648,          0,     100648,   3.555085,            99059,             1589
    4,    231,     108001,          0,     108001,   1.073057,           106579,             1422
    4,    232,     105414,          0,     105414,   0.976047,           104277,             1137
    4,    233,      96871,          0,      96871,   0.918958,            96871,                0
    4,    234,      44109,          0,      44109,   0.455338,            44109,                0
    4,    235,      34062,          0,      34062,   0.772223,            34062,                0
    4,    236,      32484,          0,      32484,   0.953673,            32484,                0
    4,    237,      31048,          0,      31048,   0.955794,            31048,                0
    4,    238,      29782,          0,      29782,   0.959224,            29782,                0
    4,    239,      28514,          0,      28514,   0.957424,            28514,                0
    4,    240,      27464,          0,      27464,   0.963176,            27464,                0
    4,    241,      26719,          0,      26719,   0.972874,            24965,             1754
    4,    242,     100155,          0,     100155,   3.748456,            98580,             1575
    4,    243,     106208,          0,     106208,   1.060436,           104786,             1422
    4,    244,     103749,          0,     103749,   0.976847,           102614,             1135
    4,    245,      95297,          0,      95297,   0.918534,            95297,                0
    4,    246,      39411,          0,      39411,   0.413560,            39411,                0
    4,    247,      31800,          0,      31800,   0.806881,            31800,                0
    4,    248,      30356,          0,      30356,   0.954591,            30356,                0
    4,    249,      29015,          0,      29015,   0.955824,            29015,                0
    4,    250,      27855,          0,      27855,   0.960021,            27855,                0
    4,    251,      26829,          0,      26829,   0.963166,            26829,                0
    4,    252,      25764,          0,      25764,   0.960304,            25764,                0
    4,    253,      25044,          0,      25044,   0.972054,            23296,             1748
    4,    254,      99229,          0,      99229,   3.962187,            97632,             1597
    4,    255,     105481,          0,     105481,   1.063006,           104023,             1458
    4,    256,     105788,          0,     105788,   1.002910,           104584,             1204
    4,    257,      97614,          0,      97614,   0.922732,            97556,               58
    4,    258,      45623,          0,      45623,   0.467382,            45623,                0
    4,    259,      32300,          0,      32300,   0.707976,            32300,                0
    4,    260,      30880,          0,      30880,   0.956037,            30880,                0
    4,    261,      29596,          0,      29596,   0.958420,            29596,                0
    4,    262,      28445,          0,      28445,   0.961110,            28445,                0
    4,    263,      27518,          0,      27518,   0.967411,            27518,                0
    4,    264,      26566,          0,      26566,   0.965404,            26566,                0
    4,    265,      25825,          0,      25825,   0.972107,            23998,             1827
    4,    266,     103598,          0,     103598,   4.011539,           101911,             1687
    4,    267,     112498,          0,     112498,   1.085909,           110990,             1508
    4,    268,     109650,          0,     109650,   0.974684,           108457,             1193
    4,    269,      98703,          0,      98703,   0.900164,            98703,                0
    4,    270,      43681,          0,      43681,   0.442550,            43681,                0
    4,    271,      33413,          0,      33413,   0.764932,            33413,                0
    4,    272,      31996,          0,      31996,   0.957591,            31996,                0
    4,    273,      30709,          0,      30709,   0.959776,            30709,                0
    4,    274,      29567,          0,      29567,   0.962812,            29567,                0
    4,    275,      28555,          0,      28555,   0.965773,            28555,                0
    4,    276,      27261,          0,      27261,   0.954684,            27261,                0
    4,    277,      26447,          0,      26447,   0.970141,            24754,             1693
    4,    278,      99263,          0,      99263,   3.753280,            97690,             1573
    4,    279,     106839,          0,     106839,   1.076323,           105397,             1442
    4,    280,     106857,          0,     106857,   1.000168,           105663,             1194
    4,    281,      99035,          0,      99035,   0.926799,            98254,              781
    4,    282,      80776,          0,      80776,   0.815631,            80776,                0
    4,    283,      33195,          0,      33195,   0.410951,            33195,                0
    4,    284,      31747,          0,      31747,   0.956379,            31747,                0
    4,    285,      30396,          0,      30396,   0.957445,            30396,                0
    4,    286,      29163,          0,      29163,   0.959435,            29163,                0
    4,    287,      28064,          0,      28064,   0.962315,            28064,                0
    4,    288,      26989,          0,      26989,   0.961695,            26989,                0
    4,    289,      26339,          0,      26339,   0.975916,            24659,             1680
    4,    290,      97480,          0,      97480,   3.700976,            95939,             1541
    4,    291,     103903,          0,     103903,   1.065890,           102498,             1405
    4,    292,     103820,          0,     103820,   0.999201,           102680,             1140
    4,    293,      95064,          0,      95064,   0.915662,            95064,                0
    4,    294,      42621,          0,      42621,   0.448340,            42621,                0
    4,    295,      32831,          0,      32831,   0.770301,            32831,                0
    4,    296,      31404,          0,      31404,   0.956535,            31404,                0
    4,    297,      30049,          0,      30049,   0.956853,            30049,                0
    4,    298,      28851,          0,      28851,   0.960132,            28851,                0
    4,    299,      27863,          0,      27863,   0.965755,            27863,                0
    4,    300,      26828,          0,      26828,   0.962854,            26828,                0
    4,    301,      26134,          0,      26134,   0.974132,            24483,             1651
    4,    302,      96521,          0,      96521,   3.693311,            94992,             1529
    4,    303,     103557,          0,     103557,   1.072896,           102171,             1386
    4,    304,     102006,          0,     102006,   0.985023,           100870,             1136
    4,    305,      94442,          0,      94442,   0.925847,            94414,               28
    4,    306,      43783,          0,      43783,   0.463597,            43783,                0
    4,    307,      33002,          0,      33002,   0.753763,            33002,                0
    4,    308,      31347,          0,      31347,   0.949852,            31347,                0
    4,    309,      30031,          0,      30031,   0.958018,            30031,                0
    4,    310,      28765,          0,      28765,   0.957844,            28765,                0
    4,    311,      27746,          0,      27746,   0.964575,            27746,                0
    4,    312,      26667,          0,      26667,   0.961111,            26667,                0
    4,    313,      25987,          0,      25987,   0.974500,            24222,             1765
    4,    314,     100984,          0,     100984,   3.885943,            99348,             1636
    4,    315,     109061,          0,     109061,   1.079983,           107562,             1499
    4,    316,     108330,          0,     108330,   0.993297,           107119,             1211
    4,    317,      98587,          0,      98587,   0.910062,            98569,               18
    4,    318,      44868,          0,      44868,   0.455111,            44868,                0
    4,    319,      34149,          0,      34149,   0.761099,            34149,                0
    4,    320,      32506,          0,      32506,   0.951887,            32506,                0
    4,    321,      31155,          0,      31155,   0.958438,            31155,                0
    4,    322,      29968,          0,      29968,   0.961900,            29968,                0
    4,    323,      29010,          0,      29010,   0.968033,            29010,                0
    4,    324,      27967,          0,      27967,   0.964047,            27967,                0
    4,    325,      27290,          0,      27290,   0.975793,            25477,             1813
    4,    326,     104530,          0,     104530,   3.830341,           102845,             1685
    4,    327,     112690,          0,     112690,   1.078064,           111150,             1540
    4,    328,     112855,          0,     112855,   1.001464,           111610,             1245
    4,    329,     103726,          0,     103726,   0.919109,           103711,               15
    4,    330,      46661,          0,      46661,   0.449849,            46661,                0
    4,    331,      35328,          0,      35328,   0.757120,            35328,                0
    4,    332,      33712,          0,      33712,   0.954257,            33712,                0
    4,    333,      32269,          0,      32269,   0.957196,            32269,                0
    4,    334,      30959,          0,      30959,   0.959404,            30959,                0
    4,    335,      29953,          0,      29953,   0.967505,            29953,                0
    4,    336,      28824,          0,      28824,   0.962308,            28824,                0
    4,    337,      28105,          0,      28105,   0.975056,            26293,             1812
    4,    338,     105882,          0,     105882,   3.767372,           104204,             1678
    4,    339,     113329,          0,     113329,   1.070333,           111829,             1500
    4,    340,     111686,          0,     111686,   0.985502,           110472,             1214
    4,    341,     101954,          0,     101954,   0.912863,           101943,               11
    4,    342,      46495,          0,      46495,   0.456039,            46495,                0
    4,    343,      35638,          0,      35638,   0.766491,            35638,                0
    4,    344,      34079,          0,      34079,   0.956255,            34079,                0
    4,    345,      32625,          0,      32625,   0.957334,            32625,                0
    4,    346,      31339,          0,      31339,   0.960582,            31339,                0
    4,    347,      30256,          0,      30256,   0.965442,            30256,                0
    4,    348,      29092,          0,      29092,   0.961528,            29092,                0
    4,    349,      28349,          0,      28349,   0.974460,            26574,             1775
    4,    350,     103953,          0,     103953,   3.666902,           102297,             1656
    4,    351,     112441,          0,     112441,   1.081652,           110959,             1482
    4,    352,     110973,          0,     110973,   0.986944,           109764,             1209
    4,    353,     101374,          0,     101374,   0.913502,           101340,               34
    4,    354,      47377,          0,      47377,   0.467349,            47377,                0
    4,    355,      35741,          0,      35741,   0.754396,            35741,                0
    4,    356,      33962,          0,      33962,   0.950225,            33962,                0
    4,    357,      32525,          0,      32525,   0.957688,            32525,                0
    4,    358,      31190,          0,      31190,   0.958955,            31190,                0
    4,    359,      30084,          0,      30084,   0.964540,            30084,                0
    4,    360,      28984,          0,      28984,   0.963436,            28984,                0
    4,    361,      28243,          0,      28243,   0.974434,            26471,             1772
    4,    362,     103885,          0,     103885,   3.678257,           102236,             1649
    4,    363,     111536,          0,     111536,   1.073649,           110017,             1519
    4,    364,     112681,          0,     112681,   1.010266,           111423,             1258
    4,    365,     103770,          0,     103770,   0.920918,           103749,               21
    4,    366,      47224,          0,      47224,   0.455083,            47224,                0
    4,    367,      35771,          0,      35771,   0.757475,            35771,                0
    4,    368,      34070,          0,      34070,   0.952448,            34070,                0
    4,    369,      32596,          0,      32596,   0.956736,            32596,                0
    4,    370,      31316,          0,      31316,   0.960731,            31316,                0
    4,    371,      30228,          0,      30228,   0.965257,            30228,                0
    4,    372,      29227,          0,      29227,   0.966885,            29227,                0
    4,    373,      28445,          0,      28445,   0.973244,            26605,             1840
    4,    374,     107033,          0,     107033,   3.762805,           105335,             1698
    4,    375,     113922,          0,     113922,   1.064363,           112382,             1540
    4,    376,     112354,          0,     112354,   0.986236,           111097,             1257
    4,    377,     104125,          0,     104125,   0.926758,           104082,               43
    4,    378,      48959,          0,      48959,   0.470194,            48959,                0
    4,    379,      36478,          0,      36478,   0.745072,            36478,                0
    4,    380,      34565,          0,      34565,   0.947557,            34565,                0
    4,    381,      33131,          0,      33131,   0.958513,            33131,                0
    4,    382,      31932,          0,      31932,   0.963810,            31932,                0
    4,    383,      30852,          0,      30852,   0.966178,            30852,                0
    4,    384,      29822,          0,      29822,   0.966615,            29822,                0
    4,    385,      29132,          0,      29132,   0.976863,            27164,             1968
    4,    386,     112846,          0,     112846,   3.873610,           111022,             1824
    4,    387,     121435,          0,     121435,   1.076113,           119770,             1665
    4,    388,     120697,          0,     120697,   0.993923,           119319,             1378
    4,    389,     111656,          0,     111656,   0.925093,           111612,               44
    4,    390,      51582,          0,      51582,   0.461972,            51582,                0
    4,    391,      38098,          0,      38098,   0.738591,            38098,                0
    4,    392,      36078,          0,      36078,   0.946979,            36078,                0
    4,    393,      34523,          0,      34523,   0.956899,            34523,                0
    4,    394,      33222,          0,      33222,   0.962315,            33222,                0
    4,    395,      32125,          0,      32125,   0.966980,            32125,                0
    4,    396,      31071,          0,      31071,   0.967191,            31071,                0
    4,    397,      30307,          0,      30307,   0.975411,            28330,             1977
    4,    398,     114000,          0,     114000,   3.761507,           112177,             1823
    4,    399,     122901,          0,     122901,   1.078079,           121244,             1657
    4,    400,     122531,          0,     122531,   0.996989,           121189,             1342
    4,    401,     112587,          0,     112587,   0.918845,           112562,               25
    4,    402,      51453,          0,      51453,   0.457007,            51453,                0
    4,    403,      38925,          0,      38925,   0.756516,            38925,                0
    4,    404,      37019,          0,      37019,   0.951034,            37019,                0
    4,    405,      35490,          0,      35490,   0.958697,            35490,                0
    4,    406,      34140,          0,      34140,   0.961961,            34140,                0
    4,    407,      32926,          0,      32926,   0.964441,            32926,                0
    4,    408,      31808,          0,      31808,   0.966045,            31808,                0
    4,    409,      30965,          0,      30965,   0.973497,            28948,             2017
    4,    410,     116351,          0,     116351,   3.757500,           114494,             1857
    4,    411,     125145,          0,     125145,   1.075582,           123465,             1680
    4,    412,     124274,          0,     124274,   0.993040,           122921,             1353
    4,    413,     112885,          0,     112885,   0.908356,           112868,               17
    4,    414,      51945,          0,      51945,   0.460159,            51945,                0
    4,    415,      39584,          0,      39584,   0.762037,            39584,                0
    4,    416,      37761,          0,      37761,   0.953946,            37761,                0
    4,    417,      36123,          0,      36123,   0.956622,            36123,                0
    4,    418,      34706,          0,      34706,   0.960773,            34706,                0
    4,    419,      33499,          0,      33499,   0.965222,            33499,                0
    4,    420,      32409,          0,      32409,   0.967462,            32409,                0
    4,    421,      31562,          0,      31562,   0.973865,            29570,             1992
    4,    422,     116112,          0,     116112,   3.678854,           114276,             1836
    4,    423,     123722,          0,     123722,   1.065540,           122053,             1669
    4,    424,     123412,          0,     123412,   0.997494,           122034,             1378
    4,    425,     114574,          0,     114574,   0.928386,           114550,               24
    4,    426,      52545,          0,      52545,   0.458612,            52545,                0
    4,    427,      39809,          0,      39809,   0.757617,            39809,                0
    4,    428,      37884,          0,      37884,   0.951644,            37884,                0
    4,    429,      36292,          0,      36292,   0.957977,            36292,                0
    4,    430,      34870,          0,      34870,   0.960818,            34870,                0
    4,    431,      33665,          0,      33665,   0.965443,            33665,                0
    4,    432,      32444,          0,      32444,   0.963731,            32444,                0
    4,    433,      31606,          0,      31606,   0.974171,            29550,             2056
    4,    434,     118300,          0,     118300,   3.742960,           116400,             1900
    4,    435,     127736,          0,     127736,   1.079763,           126044,             1692
    4,    436,     124824,          0,     124824,   0.977203,           123443,             1381
    4,    437,     114945,          0,     114945,   0.920857,           114914,               31
    4,    438,      53145,          0,      53145,   0.462352,            53145,                0
    4,    439,      40065,          0,      40065,   0.753881,            40065,                0
    4,    440,      38114,          0,      38114,   0.951304,            38114,                0
    4,    441,      36453,          0,      36453,   0.956420,            36453,                0
    4,    442,      35091,          0,      35091,   0.962637,            35091,                0
    4,    443,      33918,          0,      33918,   0.966573,            33918,                0
    4,    444,      32792,          0,      32792,   0.966802,            32792,                0
    4,    445,      31915,          0,      31915,   0.973256,            29777,             2138
    4,    446,     122489,          0,     122489,   3.837976,           120506,             1983
    4,    447,     130994,          0,     130994,   1.069435,           129197,             1797
    4,    448,     129930,          0,     129930,   0.991877,           128480,             1450
    4,    449,     118185,          0,     118185,   0.909605,           118161,               24
    4,    450,      54198,          0,      54198,   0.458586,            54198,                0
    4,    451,      41026,          0,      41026,   0.756965,            41026,                0
    4,    452,      39077,          0,      39077,   0.952494,            39077,                0
    4,    453,      37460,          0,      37460,   0.958620,            37460,                0
    4,    454,      36137,          0,      36137,   0.964682,            36137,                0
    4,    455,      34913,          0,      34913,   0.966129,            34913,                0
    4,    456,      33773,          0,      33773,   0.967347,            33773,                0
    4,    457,      32907,          0,      32907,   0.974358,            30766,             2141
    4,    458,     122698,          0,     122698,   3.728629,           120703,             1995
    4,    459,     133500,          0,     133500,   1.088037,           131699,             1801
    4,    460,     131129,          0,     131129,   0.982240,           129678,             1451
    4,    461,     120373,          0,     120373,   0.917974,           120355,               18
    4,    462,      54767,          0,      54767,   0.454977,            54767,                0
    4,    463,      41884,          0,      41884,   0.764767,            41884,                0
    4,    464,      39937,          0,      39937,   0.953514,            39937,                0
    4,    465,      38202,          0,      38202,   0.956557,            38202,                0
    4,    466,      36767,          0,      36767,   0.962436,            36767,                0
    4,    467,      35515,          0,      35515,   0.965948,            35515,                0
    4,    468,      34364,          0,      34364,   0.967591,            34364,                0
    4,    469,      33503,          0,      33503,   0.974945,            31234,             2269
    4,    470,     130481,          0,     130481,   3.894606,           128375,             2106
    4,    471,     138957,          0,     138957,   1.064960,           137053,             1904
    4,    472,     138529,          0,     138529,   0.996920,           136988,             1541
    4,    473,     126719,          0,     126719,   0.914747,           126696,               23
    4,    474,      57259,          0,      57259,   0.451858,            57259,                0
    4,    475,      43207,          0,      43207,   0.754589,            43207,                0
    4,    476,      41223,          0,      41223,   0.954082,            41223,                0
    4,    477,      39528,          0,      39528,   0.958882,            39528,                0
    4,    478,      38122,          0,      38122,   0.964430,            38122,                0
    4,    479,      36862,          0,      36862,   0.966948,            36862,                0
    4,    480,      35543,          0,      35543,   0.964218,            35543,                0
    4,    481,      34657,          0,      34657,   0.975072,            32429,             2228
    4,    482,     128824,          0,     128824,   3.717113,           126774,             2050
    4,    483,     137578,          0,     137578,   1.067953,           135744,             1834
    4,    484,     135323,          0,     135323,   0.983609,           133697,             1626
    4,    485,     129613,          0,     129613,   0.957805,           129594,               19
    4,    486,      58023,          0,      58023,   0.447663,            58023,                0
    4,    487,      43771,          0,      43771,   0.754373,            43771,                0
    4,    488,      41794,          0,      41794,   0.954833,            41794,                0
    4,    489,      39955,          0,      39955,   0.955998,            39955,                0
    4,    490,      38449,          0,      38449,   0.962308,            38449,                0
    4,    491,      37088,          0,      37088,   0.964602,            37088,                0
    4,    492,      35890,          0,      35890,   0.967698,            35890,                0
    4,    493,      35014,          0,      35014,   0.975592,            32791,             2223
    4,    494,     129277,          0,     129277,   3.692152,           127236,             2041
    4,    495,     139908,          0,     139908,   1.082234,           138026,             1882
    4,    496,     138869,          0,     138869,   0.992574,           137357,             1512
    4,    497,     126369,          0,     126369,   0.909987,           126356,               13
    4,    498,      57747,          0,      57747,   0.456971,            57747,                0
    4,    499,      44326,          0,      44326,   0.767590,            44326,                0
    4,    500,      42290,          0,      42290,   0.954068,            42290,                0
